NO ./textures/north.xpm
SO ./textures/south.xpm
WE ./textures/west.xpm
EA ./textures/east.xpm

F 125,125,125
C 10,10,225

11111
10001
1N001
11111
